MESE,FL_IMP,CP_IMP,ST_IMP,FL_PER,CP_PER,ST_PER,FL_AZR,CP_AZR,ST_AZR,FL_RET,CP_RET,ST_RET,FL_TOTRET_calcolato,CP_TOTRET_calcolato,ST_TOTRET_calcolato,FL_BDT_calcolato,CP_BDT_calcolato,ST_BDT_calcolato
2011/01,461,660,119425,2914,3920,1794132,5605,6157,888311,46605,33510,8170283,52210,39667,9058594,55585,44247,10972151
2011/02,505,811,118247,2875,4870,1794750,6786,7671,887050,41718,40075,8169959,48504,47746,9057009,51884,53427,10970006
2011/03,564,853,117783,3551,5486,1793205,10615,7849,891283,45593,42390,8171023,56208,50239,9062306,60323,56578,10973294
2011/04,465,675,117588,2799,4103,1793468,5892,6413,891569,38851,32381,8174662,44743,38794,9066231,48007,43572,10977287
2011/05,504,757,117347,3078,4741,1796698,10477,6965,892921,42435,41015,8184246,52912,47980,9077167,56494,53478,10991212
2011/06,469,772,117061,3512,4374,1797243,6339,6899,892492,45112,37556,8188931,51451,44455,9081423,55432,49601,10995727
2011/07,463,658,116863,2865,4297,1796910,5366,6527,891212,43724,35448,8194976,49090,41975,9086188,52418,46930,10999961
2011/08,213,447,116644,2565,3405,1797220,2816,4450,889329,35055,29202,8198799,37871,33652,9088128,40649,37504,11001992
2011/09,419,814,116153,3843,4882,1794633,5017,7265,881239,51294,44380,7987902,56311,51645,8869141,60573,57341,10779927
2011/10,435,741,115856,6029,4585,1796388,5737,6492,880170,51949,36274,8000867,57686,42766,8881037,64150,48092,10793281
2011/11,459,831,115522,5529,4790,1800074,9013,7425,879335,45456,41476,8001683,54469,48901,8881018,60457,54522,10796614
2011/12,418,1544,114433,6856,6602,1799328,5273,12242,869133,70312,54070,8019153,75585,66312,8888286,82859,74458,10802047
2012/01,444,758,113885,4279,2929,1527391,7623,7371,870429,80123,40153,8332695,87746,47524,9203124,92469,51211,10844400
2012/02,442,690,113273,3095,3097,1531984,7613,7173,872047,69329,38424,8354787,76942,45597,9226834,80479,49384,10872091
2012/03,491,707,113023,3147,3360,1535342,9539,7646,873771,73915,42549,8380735,83454,50195,9254506,87092,54262,10902871
2012/04,381,603,112818,2191,2745,1538385,5366,6003,873402,50212,32625,8392996,55578,38628,9266398,58150,41976,10917601
2012/05,521,721,112657,2825,3476,1539624,6441,7310,872194,57629,38823,8408464,64070,46133,9280658,67416,50330,10932939
2012/06,344,639,112267,2630,2956,1542274,5334,6443,870863,51062,31366,8425484,56396,37809,9296347,59370,41404,10950888
2012/07,369,649,111472,2624,2893,1543885,4887,6458,868758,58065,30780,8444965,62952,37238,9313723,65945,40780,10969080
2012/08,191,558,111119,2124,2895,1544928,3147,6268,865664,46500,31140,8456993,49647,37408,9322657,51962,40861,10978704
2012/09,232,747,110589,2319,2706,1547743,4011,7100,862177,53988,30966,8475513,57999,38066,9337690,60550,41519,10996022
2012/10,386,872,109112,2679,3365,1551050,5499,8207,856756,56781,35456,8477690,62280,43663,9334446,65345,47900,10994608
2012/11,307,801,108059,2237,3381,1551740,4899,7154,853497,48248,32807,8484823,53147,39961,9338320,55691,44143,10998119
2012/12,280,1175,106708,1506,3620,1551213,3403,9285,847177,38063,34061,8483507,41466,43346,9330684,43252,48141,10988605
2013/01,432,872,107891,3489,3249,1568612,7558,8132,856273,59606,35777,8571652,67164,43909,9427925,71085,48030,11104428
2013/02,434,749,107585,3002,4034,1570352,7550,7421,855757,48291,34265,8579480,55841,41686,9435237,59277,46469,11113174
2013/03,460,825,107206,2462,3952,1572785,7579,7955,854766,46624,36147,8583305,54203,44102,9438071,57125,48879,11118062
2013/04,305,709,106620,2427,3670,1576547,6581,6700,852468,42050,32317,8581804,48631,39017,9434272,51363,43396,11117439
2013/05,369,844,106160,2438,3987,1578797,6934,7368,851669,44388,50748,8570309,51322,58116,9421978,54129,62947,11106935
2013/06,284,739,105718,2025,3205,1578295,5905,5891,851505,39081,29181,8578465,44986,35072,9429970,47295,39016,11113983
2013/07,296,746,105270,2036,3630,1578931,5753,6655,850125,46187,32942,8587829,51940,39597,9437954,54272,43973,11122155
2013/08,162,629,104979,1405,3284,1578477,3055,5378,847759,34753,34722,8582345,37808,40100,9430104,39375,44013,11113560
2013/09,204,936,104221,1931,3555,1578440,4091,6873,844710,46121,36509,8587022,50212,43382,9431732,52347,47873,11114393
2013/10,278,1021,103432,1986,3846,1579005,4996,7743,841757,43934,51225,8574973,48930,58968,9416730,51194,63835,11099167
2013/11,242,827,102804,1668,3625,1577685,4527,6619,839599,39935,32657,8579424,44462,39276,9419023,46372,43728,11099512
2013/12,243,1304,101712,1358,4183,1573520,3208,9172,833560,33301,39612,8568959,36509,48784,9402519,38110,54271,11077751
2014/01,335,971,100908,2730,3705,1577109,6098,7433,831412,47163,43471,8565329,53261,50904,9396741,56326,55580,11074758
2014/02,340,763,100418,2477,3800,1577786,6239,7457,830471,39109,46293,8551984,45348,53750,9382455,48165,58313,11060659
2014/03,361,767,100006,2641,3844,1578530,6065,7029,829710,40982,34492,8554125,47047,41521,9383835,50049,46132,11062371
2014/04,329,695,99652,1715,3194,1578559,5342,6683,828874,36191,41467,8544840,41533,48150,9373714,43577,52039,11051925
2014/05,290,781,99173,1485,3871,1603236,5048,6192,822520,39291,30611,8529669,44339,36803,9352189,46114,41455,11054598
2014/06,234,626,98774,1308,2749,1605096,4327,5184,822654,35519,28283,8531376,39846,33467,9354030,41388,36842,11057900
2014/07,326,712,98336,1629,3394,1606676,4962,5993,822586,43369,32712,8536290,48331,38705,9358876,50286,42811,11063888
2014/08,141,531,97944,1083,2796,1607064,2573,4499,821579,30230,25657,8536587,32803,30156,9358166,34027,33483,11063174
2014/09,249,801,97472,1501,3273,1609538,3925,6002,821435,43385,29036,8543469,47310,35038,9364904,49060,39112,11071914
2014/10,281,910,96882,1592,3772,1607849,4687,7448,819406,41191,44299,8537253,45878,51747,9356659,47751,56429,11061390
2014/11,248,744,96096,1391,2942,1629183,3833,5615,809827,35866,27087,8506574,39699,32702,9316401,41338,36388,11041680
2014/12,254,1025,95380,1092,3519,1624757,2887,8003,805116,40867,37075,8508871,43754,45078,9313987,45100,49622,11034124
2015/01,292,1102,182857,1447,2473,1538510,3689,5372,577062,37570,28877,8850177,41259,34249,9427239,42998,37824,11148606
2015/02,497,1015,182437,2084,3004,1537689,4383,4838,577906,36008,32517,8851204,40391,37355,9429110,42972,41374,11149236
2015/03,569,1198,181738,2442,3983,1532142,4595,5807,578103,39800,39135,8850563,44395,44942,9428666,47406,50123,11142546
2015/04,582,1022,181253,2206,3717,1531468,4048,5070,577955,35581,36404,8843375,39629,41474,9421330,42417,46213,11134051
2015/05,553,1072,180700,2938,3745,1532245,3772,4705,577855,35061,33692,8838923,38833,38397,9416778,42324,43214,11129723
2015/06,575,1051,180276,3548,3623,1534794,3315,4288,577488,36664,31659,8836252,39979,35947,9413740,44102,40621,11128810
2015/07,736,1063,179781,3893,3553,1538021,3659,4320,577050,42562,31927,8838799,46221,36247,9415849,50850,40863,11133651
2015/08,267,855,179167,2577,2931,1538666,2055,3537,576223,29827,26999,8837611,31882,30536,9413834,34726,34322,11131667
2015/09,518,1025,178662,4613,2986,1541996,3329,4214,576388,45579,28785,8849587,48908,32999,9425975,54039,37010,11146633
2015/10,641,1285,178026,4245,3746,1545261,3502,5580,574699,42654,47807,8838482,46156,53387,9413181,51042,58418,11136468
2015/11,663,1366,177128,4618,3550,1547812,3129,5255,572739,40837,37973,8830884,43966,43228,9403623,49247,48144,11128563
2015/12,609,1789,175901,6807,3945,1551728,2847,6740,569379,46210,41468,8831017,49057,48208,9400396,56473,53942,11128025
2016/01,761,1377,209758,5762,4160,1653985,4270,5076,536094,50317,37012,8728887,54587,42088,9264981,61110,47625,11128724
2016/02,891,1399,208876,5184,4418,1656428,4632,5354,536035,47143,43378,8726225,51775,48732,9262260,57850,54549,11127564
2016/03,928,1408,208278,4518,4192,1659195,4647,5417,535827,42732,45515,8717018,47379,50932,9252845,52825,56532,11120318
2016/04,871,1168,207979,3816,4071,1660363,4034,4654,535989,37650,41372,8707340,41684,46026,9243329,46371,51265,11111671
2016/05,790,1291,207448,4342,4378,1661917,4028,4751,535830,39217,39515,8693881,43245,44266,9229711,48377,49935,11099076
2016/06,817,1250,207023,3664,3813,1664108,3540,4309,535399,37420,36092,8695392,40960,40401,9230791,45441,45464,11101922
2016/07,858,1209,206661,4060,3509,1666064,3505,4046,535226,42225,34491,8699706,45730,38537,9234932,50648,43255,11107657
2016/08,438,1066,206016,3096,3272,1667229,2244,3674,534151,33545,27714,8701647,35789,31388,9235798,39323,35726,11109043
2016/09,800,1206,205617,4558,3274,1670647,3230,4328,533189,44342,29604,8712229,47572,33932,9245418,52930,38412,11121682
2016/10,891,1279,205249,4601,3687,1673387,3287,4745,532021,38435,53391,8691340,41722,58136,9223361,47214,63102,11101997
2016/11,934,1300,204814,4641,3759,1676567,3312,4547,530935,38272,37268,8684640,41584,41815,9215575,47159,46874,11096956
2016/12,743,2215,203305,5826,4149,1680082,2864,5766,528372,40190,39150,8684819,43054,44916,9213191,49623,51280,11096578
2017/01,1012,1438,202849,4460,4523,1743622,3693,5000,528992,43630,36245,8627390,47323,41245,9156382,52795,47206,11102853
2017/02,1162,1061,202964,3849,4235,1745041,4475,4113,529680,37511,35527,8620181,41986,39640,9149861,46997,44936,11097866
2017/03,1283,1538,202741,3817,4819,1746265,5053,5894,529276,41003,42037,8614043,46056,47931,9143319,51156,54288,11092325
2017/04,934,969,202713,3040,3891,1746983,4039,3399,530250,33141,30508,8612356,37180,33907,9142606,41154,38767,11092302
2017/05,1217,1249,202729,3715,4924,1747473,4706,4342,530986,40803,37911,8609929,45509,42253,9140915,50441,48426,11091117
2017/06,1028,1132,202670,3165,4637,1747910,3661,3689,531288,37534,33095,8609589,41195,36784,9140877,45388,42553,11091457
